
F 2, 1, 250
NO ./pics/bluestone.xpm
SO ./pics/flagsvastiki.xpm
C	65		   ,	  255	 ,       255
WE ./pics/bantik.xpm
EA ./pics/greystone.xpm
1111111111111111111111111
1000000000110000000000001
1011000001110000000000001                          111111
100100000000001000000000111111111             11111110111
111111111011000001110000000000001                   11111
10000000001100N001110111101111111
1111011011111101110000001000111111
111110100001111011101010010001
111110001101010111000000100011111
10000000000000001100000010001
10000000000000001101010010001
1100000111010101111101111000111
11110111 1110101 101111010001
11111111 1111111 111111111111
          111
        1111111
      11111111111