111111111111111111111111111111111
100000000000000000110000000000001
110000000000000001110000000000001
100000000001000000000000000000001
100000000000000000000000000000001
101000000011000000000010000000001
1000000000N0000000000000100000001
100100000000000000010100100000001
100000000000000000000000100000001
100000000000000000000000100000001
100000011100000000101001000000001
111111111111111111111111111111111