111111111111121113111111111111111
100000000000000000000000000000001
110000000000000000000000000000001
100000000001000000000000000000001
100000000000000200000000000000001
201000000010000000000010000000001
1000000000S0000000000000100000001
100100000000000000010100100000002
100000000000000000000000100000001
100000000000000000000000100000001
100000010000000000101001000000001
111111111131111111111211111111111