NO ./pics/bluestone.xpm
SO ./pics/greystone.xpm
WE ./pics/eagle.xpm
EA ./pics/redbrick.xpm
F 71,19,0000021
C 26,67,96

111111111111111111111111111111111111
100000000000000000000000000000000001
100000000000000000000000000000000001
100000000000000000000000000000000001
100000000000000000000000000000000001
10000W000000000000000000000000000001
100000000000000000000000000000000001
111111111111111111111111111111111111