111111111111111111112111111111111111
101000000100000000000000000000000001
100000000000000000000000000000000001
100100010000001000000000000011010001
10000000000000000000000200000W110001
100010000000000000000000000010100001
100000000001000000000000000000000001
100001001000000100000000010003000001
110100000000000000000000000000000001
111111111111111113111111111111111111