111111111111111111111111111111111111
101000000000000000000000000000000001
101000000000000000000000100000000001
101000010000000000000000000011110001
101000001010101010010000000011110001
1010100000000000N0000000000011110001
101000000000000000000000000000000001
100000000000000000000000000000000001
11010000000N000000000000000000000001
111111111111111111111111111111111111