111111111111111111111111111111111111
101000000000000000000000000000000001
101000000000000000000000000000000001
101000010000000000000000000011110001
10100000000000000000000000000W110001
101010000000000000000000000011110001
101000000000000000000000000000000001
100000000000000000000000000000000001
110100000000000000000000000000000001
111111111111111111111111111111111111